00000000000000000000
00000000000000000000
00000000000000000000
00110000002222000000
00110000000002000000
00111111133332000000
00111111133332220000
00111111111112110000
00111111111112220000
00111111100001110000
00111111122222222000
00111113003331100000
00110333003331100000
00110311111111100000
00110333003331100000
00111111111111100000
00000011000000000000
00000011000000000000
00000000000000000000
00000000000000000000