00000000000000000000
00000000000000000000
00000000000000000000
00110000022222000000
00110000022222000000
00111111122222000000
00111111122222220000
00000001111112110000
00000001111112220000
00000001100001110000
00111111122222222000
00110333003331100000
00110333003331100000
00110333223331100000
00110333003331100000
00111133333333311100
00000033000000000000
00000033000000000000
00000000000000000000
00000000000000000000