00000000000000000000
00000000000000000000
00000000000000000000
00110000002222000000
00110000000002000000
00111111100002000000
00111111100002220000
00000001111112110000
00000001111112220000
00000001100001110000
00111111122222222000
00110333003331100000
00110333003331100000
00110333223331100000
00110333003331100000
00111111111111100000
00000011000000000000
00000011000000000000
00000000000000000000
00000000000000000000